   # # # # # # # # #                                                      
 # . . . . . . . . . #                                                    
 # . # # # # # # # . #                                                    
 # . . . # . . . . . #                                                    
 # . # . # # # # # . # # # #                       # # #                  
 # . # . # . . . # . . . . . #                   # . . . #                
   # # . # . # . # # # # # . # # # #       # # # # . # . # #              
 # . . . # . # . # . . . # . # . . . #   # . . . . . # . . . #            
 # . # . # . # . # . # # # . # . # . # # # . # # # #   # # . # # # #      
 # . # . # . # . # . . . . . # . # . . . # . . . # . # . . . # . . . #    
 # . # # # . # . # # # # # . # . # # # . # # # . # . # . # # # . # . #    
 # . # . . . # . # . . . # . . . # . # . . . . . # . # . # . . . # . #    
 # . # . # # # . # . # . # # # # # . # # # # # # # . # . # . # # # . #    
 # . . . # . # . . . # . # . . . # . . . . . . . . . . . . . # . . . .    
 # . # # # . # # # # # . # . # . # # # . # # # # # . # # # # # # # # #    
 # . # . . . . . . . # . . . # . . . # . # . . . # . # . . . . . #        
 # . # # # . # # # . # # # # # # # . # . # . # . # # # . # # # . #        
 # . # . . . # . . . . . . . . . # . # . # . # . . . . . # . # . #        
 # . # . # # # . # # # # # # # # # . # . # . # # # # # # # . # . #        
 # . . . # . # . . . # . . . . . # . # . # O # . . . . . . . . . #        
   # # # # . # . # # # . # # # . # . # . # # # . # # # # # # # #          
 # . . . # . . . # . . . # . # . . . # . . . # . #                        
   # # . # . # # # . # # # . # # # # # # # . # . # # # #                  
 # . . . # . # . # . . . # . . . # . . . . . # . . . . . #                
 # . # . # . # . # # # . # . # # # . # # # #   # # # # . #                
 # . # . # . . . # . # . # . . . . . . . . . # . . . # . #                
 # . # # # # # . # . # . # # # # # # # # # . # . # # # . #                
 # . # . . . . . # . # . . . . . # . . . # . # . # . . . #                
 # . # . # # # # # . # # # # # . # . # # # . # . # . # # # # # # # #      
 # . . . # . . . . . . . # . . . # . . . . . . . # . # . . . . . . . #    
 # . # # # . # # # # # . # . # . # # # # # # # . # . # # # . # # # . #    
 # . . . # . # . . . # . # . # . # . . . . . # . # . # . . . # . . . #    
   # # . # . # # # . # . # . # # # . # # # . # # # . # . # # # . # #      
   X # . . . # . . . # . # . # . . . # . # . . . # . . . # . # . . . #    
 # .   # # # # . # # # . # . # . # # # . # # # . # # # # # . # # # . # #  
 # . # . . . . . # . . . # . # . # . . . # . # . . . . . . . . . # . . . #
 # . # . # . # # # . # # # . # . # . # . # . # # # # # # # . # # # # # . #
 # . . . # . . . . . . . # . . . . . # . . . . . . . . . # . . . . . . . #
   # # #   # # # # # # #   # # # # #   # # # # # #   # #   # # # # # # #  
